R------RR
--RRRR-RR
-R---R---
-R-R-----
-R-R-----
-R-R-R---
-R-R---R-
-R----R--
--RRRR--R
R------RR
