R------RR
--RRRR-RR
-R---R-RR
-R-R---R-
-R-R-PRRR
-R-R-R---
-R-R---R-
-R----R--
--RRRR--R
R------RR