R--A--RRR
--RRRR-RR
-R---R---
-R-R-----
-R-R-PRRR
-R-R-R---
-R-R---R-
-R----R--
--RRRR--R
R------RR
