RRRRRRRRRRRRRRRR
R--------------R
R--RRRRRRRRRR--R
R--R--------R--R
R--R--P-----R--R
R--R--------R--R
R--RRRRRRRRRR--R
R--------------R
RRRRRRRRRRRRRRRR
RRRRRRRRRRRRRRRR
R--------------R
R--RRRRRRRRRR--R
R--R--------R--R
R--R--------R--R
R--R--------R--R
RRRRRRRRRRRRRRRR
